Ability name (in the AI)	4-letter-code
AVATAR	AHav
BASH	AHbh
THUNDER_BOLT	AHtb
THUNDER_CLAP	AHtc
DEVOTION_AURA	AHad
DIVINE_SHIELD	AHds
HOLY_BOLT	AHhb
RESURRECTION	AHre
BLIZZARD	AHbz
BRILLIANCE_AURA	AHab
MASS_TELEPORT	AHmt
WATER_ELEMENTAL	AHwe
BANISH	AHbn
FLAME_STRIKE	AHfs
SUMMON_PHOENIX	AHpx
SIPHON_MANA	AHdr
CRITICAL_STRIKE	AOcr
MIRROR_IMAGE	AOmi
BLADE_STORM	AOww
WIND_WALK	AOwk
CHAIN_LIGHTNING	AOcl
EARTHQUAKE	AOeq
FAR_SIGHT	AOfs
SPIRIT_WOLF	AOsf
ENDURANCE_AURA	AOr2
ENDURANE_AURA	AOae
REINCARNATION	AOre
SHOCKWAVE	AOsh
WAR_STOMP	AOws
HEALING_WAVE	AOhw
HEX	AOhx
SERPENT_WARD	AOsw
VOODOO	AOvd
SLEEP	AUsl
VAMP_AURA	AUav
CARRION_SWARM	AUcs
INFERNO	AUin
DARK_RITUAL	AUdr
DEATH_DECAY	AUdd
FROST_ARMOR	AUfu
FROST_NOVA	AUfn
ANIM_DEAD	AUan
DEATH_COIL	AUdc
DEATH_PACT	AUdp
UNHOLY_AURA	AUau
CARRION_SCARAB	AUcb
IMPALE	AUim
LOCUST_SWARM	AUls
THORNY_SHIELD	AUts
FORCE_NATURE	AEfn
ENT_ROOTS	AEer
THORNS_AURA	AEah
TRANQUILITY	AEtq
EVASION	AEev
IMMOLATION	AEim
MANA_BURN	AEmb
METAMORPHOSIS	AEme
SEARING_ARROWS	AHfa
SCOUT	AEst
STARFALL	AEsf
TRUESHOT	AEar
BLINK	AEbl
FAN_KNIVES	AEfk
SHADOW_TOUCH	AEsh
VENGEANCE	AEsv
BLACKARROW	ANba
CHARM	ANch
DRAIN	ANdr
SILENCE	ANsi
FORKLIGHTNING	ANfl
FROSTARROWS	ANfa
TORNADO	ANto
MANASHIELD	ANms
BOF	ANbf
BRAWLER	ANdb
HAZE	ANdh
SEF	ANef
DOOM	ANdo
HOWL	ANht
CLEAVING	ANca
RAINOFFIRE	ANrf
STAMPEDE	ANst
BEAR	ANsg
QUILBEAST	ANsq
HAWK	ANsw
POCKETFACTORY	ANsy
POCKETFACTORY1	ANs1
POCKETFACTORY2	ANs2
POCKETFACTORY3	ANs3
ROBOGOBLIN	ANrg
ROBOGOBLIN1	ANg1
ROBOGOBLIN2	ANg2
ROBOGOBLIN3	ANg3
UPGRADE	ANeg
ROCKETS	ANcs
ROCKETS1	ANc1
ROCKETS2	ANc2
ROCKETS3	ANc3
INCINERATE	ANia
SOUL_BURN	ANso
SUMMON_LAVASPAWN	ANlm
VOLCANO	ANvc
HEALING_SPRAY	ANhs
ACID_BOMB	ANab
CHEMICAL_RAGE	ANcr
TRANSMUTE	ANtm
